10 11 11 11 11 11 11 11 11 11 11 11 11 11 12 0 0 10 11 11 11 11 11 11 11 11 11 11 11 11 11 12 0 0 10 11 11 11 11 11 11 11 11 11 11 11 11 11 12 0 
10 1 2 2 2 2 2 2 2 2 2 2 2 3 12 0 0 10 1 2 2 2 2 2 2 2 2 2 2 2 3 12 0 0 10 1 2 2 2 2 2 2 2 2 2 2 2 3 12 0 
10 4 5 5 5 5 5 5 5 5 5 5 5 6 11 11 11 11 4 5 5 5 5 5 5 5 5 5 5 5 6 11 11 11 11 4 5 5 5 5 5 5 5 5 5 5 5 6 12 0 
10 4 5 5 5 5 5 5 5 5 5 5 5 5 2 2 2 2 5 5 5 5 5 5 5 5 5 5 5 5 5 2 2 2 2 5 5 5 5 5 5 5 5 5 5 5 5 6 12 0 
10 4 5 5 5 5 5 5 5 5 5 5 5 5 5 5 5 5 5 5 5 5 5 5 5 5 5 5 5 5 5 5 5 5 5 5 5 5 5 5 5 5 5 5 5 5 5 6 12 0 
10 4 5 5 5 5 5 5 5 5 5 5 5 5 8 8 8 8 5 5 5 5 5 5 5 5 5 5 5 5 5 8 8 8 8 5 5 5 5 5 5 5 5 5 5 5 5 6 12 0 
10 4 5 5 5 5 5 5 5 5 5 5 5 6 17 14 14 16 4 5 5 5 5 5 5 5 5 5 5 5 6 17 14 14 16 4 5 5 5 5 5 5 5 5 5 5 5 6 12 0 
10 7 8 8 8 8 5 5 5 8 8 8 8 9 12 0 0 10 7 8 8 8 8 5 5 5 8 8 8 8 9 12 0 0 10 7 8 8 8 8 5 5 5 8 8 8 8 9 12 0 
13 14 14 14 14 16 4 5 6 17 14 14 14 14 15 0 0 13 14 14 14 14 16 4 5 6 17 14 14 14 14 15 0 0 13 14 14 14 14 16 4 5 6 17 14 14 14 14 15 0 
0 0 0 0 0 10 4 5 6 12 0 0 0 0 0 0 0 0 0 0 0 0 10 4 5 6 12 0 0 0 0 0 0 0 0 0 0 0 0 10 4 5 6 12 0 0 0 0 0 0 
0 0 0 0 10 11 4 5 6 11 12 0 0 0 0 0 10 11 11 11 11 11 11 4 5 6 11 11 11 11 11 11 11 11 11 11 11 11 11 11 4 5 6 12 0 0 0 0 0 0 
0 0 10 11 11 1 5 5 5 3 11 11 12 0 0 0 10 1 2 2 2 2 2 5 5 5 2 2 2 2 2 2 2 2 2 2 2 2 2 2 5 5 6 12 0 0 0 0 0 0 
0 0 10 1 2 5 5 5 5 5 2 3 12 0 0 0 10 4 5 5 5 5 5 5 5 5 5 5 5 5 5 5 5 5 5 5 5 5 5 5 5 5 6 12 0 0 0 0 0 0 
0 10 11 4 5 5 5 5 5 5 5 6 11 12 0 0 10 4 5 5 8 8 8 8 8 8 8 8 8 8 8 8 8 8 8 8 8 8 8 8 5 5 6 12 0 0 0 0 0 0 
0 10 1 5 5 5 5 5 5 5 5 5 3 11 11 11 11 4 5 6 11 11 11 11 11 11 11 11 11 11 11 11 11 11 11 17 14 14 16 11 4 5 6 11 11 11 11 12 0 0 
0 10 4 5 5 5 5 5 5 5 5 5 5 2 2 2 2 5 5 5 2 2 2 2 2 2 2 2 2 2 2 2 2 2 3 12 0 0 10 1 5 5 5 2 2 2 3 12 0 0 
0 10 4 5 5 5 5 5 5 5 5 5 5 5 5 5 5 5 5 5 5 5 5 5 5 5 5 5 5 5 5 5 5 5 6 12 0 0 10 4 5 5 5 5 5 5 6 12 0 0 
0 10 4 5 5 5 5 5 5 5 5 5 5 8 8 8 8 5 5 5 8 8 8 8 8 8 8 8 8 8 8 8 5 5 6 12 0 0 10 4 5 5 5 5 5 5 6 12 0 0 
0 10 7 5 5 5 5 5 5 5 5 5 9 17 14 14 16 4 5 6 17 14 14 14 14 14 14 14 14 14 14 16 4 5 6 12 0 0 10 4 5 5 5 5 5 5 6 12 0 0 
0 13 16 4 5 5 5 5 5 5 5 6 17 15 0 0 10 4 5 6 12 0 0 0 0 0 0 0 0 0 0 10 4 5 6 12 0 0 10 4 5 5 5 5 5 5 6 12 0 0 
0 0 10 7 8 5 5 5 5 5 8 9 12 0 0 0 10 4 5 6 12 0 0 0 0 0 0 0 0 0 0 10 4 5 6 12 0 0 10 7 8 8 8 8 8 8 9 12 0 0 
0 0 13 14 16 7 5 5 5 9 17 14 15 0 0 0 10 4 5 6 11 11 11 11 11 11 11 11 11 11 11 11 4 5 6 12 0 0 13 14 14 14 14 14 14 14 14 15 0 0 
0 0 0 0 13 16 4 5 6 17 15 0 0 10 11 11 11 4 5 5 2 2 2 2 2 2 2 2 2 2 2 2 5 5 6 11 11 11 11 11 11 11 11 11 11 11 11 11 12 0
0 0 0 0 0 10 4 5 6 12 0 0 0 10 1 2 2 5 5 5 5 5 5 5 5 5 5 5 5 5 5 5 5 5 5 2 2 2 2 2 2 2 2 2 2 2 2 3 12 0 
0 0 0 0 0 10 4 5 6 12 0 0 0 10 4 5 5 5 5 5 8 8 8 5 5 5 8 8 8 8 8 8 5 5 5 5 5 5 5 5 5 5 5 5 5 5 5 6 12 0 
0 0 0 10 11 11 4 5 6 11 11 12 0 10 4 5 5 8 8 9 17 14 16 4 5 6 17 14 14 14 14 16 7 8 8 8 8 8 8 8 8 8 8 8 8 8 8 9 12 0 
0 0 0 10 1 2 5 5 5 2 3 12 0 10 4 5 6 17 14 14 15 0 10 4 5 6 12 0 0 0 0 13 14 14 14 14 14 14 14 14 14 14 14 14 14 14 14 14 15 0 
0 0 0 10 4 5 5 5 5 5 6 12 0 10 4 5 6 12 0 0 0 0 10 4 5 6 12 0 0 0 0 0 0 0 0 0 0 0 0 0 0 0 0 0 0 0 0 0 0 0 
0 0 0 10 4 5 5 5 5 5 6 11 11 11 4 5 6 12 0 0 0 0 10 7 8 9 12 0 10 11 11 11 11 11 11 11 11 11 11 11 11 11 11 11 11 11 11 11 11 12 
0 0 0 10 4 5 5 5 5 5 5 2 2 2 5 5 6 12 0 0 0 0 13 14 14 14 15 0 10 1 2 2 2 2 2 2 2 2 2 2 2 2 2 2 2 2 2 2 3 12 
0 0 0 10 4 5 5 5 5 5 5 5 5 5 5 5 6 12 0 0 0 0 0 0 0 0 0 0 10 4 5 5 5 5 5 5 5 5 5 5 5 5 5 5 5 5 5 5 6 12 
0 0 0 10 4 5 5 5 5 5 5 8 8 8 5 5 6 12 0 0 0 0 0 0 0 0 0 0 10 4 5 5 5 5 5 5 5 5 5 5 5 5 5 5 5 5 5 5 6 12 
0 0 0 10 4 5 5 5 5 5 6 17 14 16 4 5 6 11 11 11 11 11 11 11 11 11 12 0 10 4 5 5 5 5 5 5 5 5 5 5 5 5 5 5 5 5 5 5 6 12 
0 0 0 10 4 5 5 5 5 5 6 12 0 10 4 5 5 2 2 2 2 2 2 2 2 3 12 0 10 4 5 5 5 5 5 5 5 5 5 5 5 5 5 5 5 5 5 5 6 12 
0 0 0 10 4 5 5 5 5 5 6 12 0 10 4 5 5 5 5 5 5 5 5 5 5 6 12 0 10 4 5 5 5 5 5 5 5 5 5 5 5 5 5 5 5 5 5 5 6 12 
0 0 0 10 4 5 5 5 5 5 6 12 0 10 4 5 5 8 8 8 8 8 8 5 5 6 12 0 10 4 5 5 5 5 5 5 5 5 5 5 5 5 5 5 5 5 5 5 6 12 
0 0 0 10 4 5 5 5 5 5 6 12 0 10 4 5 6 17 14 14 14 16 11 4 5 6 11 12 10 4 5 5 5 5 5 5 5 5 5 5 5 5 5 5 5 5 5 5 6 12 
0 0 0 10 7 8 5 5 5 8 9 12 0 10 4 5 6 12 0 0 0 10 1 5 5 5 3 12 10 4 5 5 5 5 5 5 5 5 5 5 5 5 5 5 5 5 5 5 6 12 
0 0 0 13 14 16 4 5 6 17 14 15 0 10 7 8 9 12 0 0 0 10 4 5 5 5 6 12 10 4 5 5 5 5 5 5 5 5 5 5 5 5 5 5 5 5 5 5 6 12 
0 0 0 0 0 10 4 5 6 12 0 0 0 13 14 14 14 15 0 0 0 10 4 5 5 5 6 12 10 4 5 5 5 5 5 5 5 5 5 5 5 5 5 5 5 5 5 5 6 12 
0 0 0 0 0 10 4 5 6 12 0 0 0 0 0 0 0 0 0 0 0 10 7 8 8 8 9 12 10 4 5 5 5 5 5 5 5 5 5 5 5 5 5 5 5 5 5 5 6 12 
10 11 11 11 11 11 4 5 6 11 11 11 11 11 12 0 0 0 0 0 0 13 14 14 14 14 14 15 10 4 5 5 5 5 5 5 5 5 5 5 5 5 5 5 5 5 5 5 6 12 
10 1 2 2 2 2 5 5 5 2 2 2 2 3 12 0 0 0 0 0 0 0 0 0 0 0 0 0 10 4 5 5 5 5 5 5 5 5 5 5 5 5 5 5 5 5 5 5 6 12 
10 4 5 5 5 5 5 5 5 5 5 5 5 6 11 11 11 11 11 11 11 11 11 11 11 11 11 11 11 4 5 5 5 5 5 5 5 5 5 5 5 5 5 5 5 5 5 5 6 12 
10 4 5 5 5 5 5 5 5 5 5 5 5 5 2 2 2 2 2 2 2 2 2 2 2 2 2 2 2 5 5 5 5 5 5 5 5 5 5 5 5 5 5 5 5 5 5 5 6 12 
10 4 5 5 5 5 5 5 5 5 5 5 5 5 5 5 5 5 5 5 5 5 5 5 5 5 5 5 5 5 5 5 5 5 5 5 5 5 5 5 5 5 5 5 5 5 5 5 6 12 
10 4 5 5 5 5 5 5 5 5 5 5 5 5 8 8 8 8 8 8 8 8 8 8 8 8 8 8 8 5 5 5 5 5 5 5 5 5 5 5 5 5 5 5 5 5 5 5 6 12 
10 4 5 5 5 5 5 5 5 5 5 5 5 6 17 14 14 14 14 14 14 14 14 14 14 14 14 14 16 4 5 5 5 5 5 5 5 5 5 5 5 5 5 5 5 5 5 5 6 12 
10 7 8 8 8 8 8 8 8 8 8 8 8 9 12 0 0 0 0 0 0 0 0 0 0 0 0 0 10 7 8 8 8 8 8 8 8 8 8 8 8 8 8 8 8 8 8 8 9 12 
13 14 14 14 14 14 14 14 14 14 14 14 14 14 15 0 0 0 0 0 0 0 0 0 0 0 0 0 13 14 14 14 14 14 14 14 14 14 14 14 14 14 14 14 14 14 14 14 14 15